"aX" = (/turf/template_noop,/area/space)
"bs" = (/obj/structure/shuttle/part/tornado/transparent{icon_state = "26"},/turf/template_noop,/area/shuttle/tornado)
"by" = (/obj/structure/surface/table/almayer,/obj/item/weapon/gun/rifle/rmc_f90/bionational{pixel_y = 14},/obj/item/weapon/gun/rifle/rmc_f90/bionational{pixel_y = 8},/obj/item/weapon/gun/rifle/rmc_f90/bionational,/obj/item/ammo_magazine/rifle/rmc_f90/pve,/obj/item/ammo_magazine/rifle/rmc_f90/pve{pixel_x = 7},/obj/item/ammo_magazine/rifle/rmc_f90/pve{pixel_x = -6},/obj/item/ammo_magazine/rifle/rmc_f90/pve,/obj/item/ammo_magazine/rifle/rmc_f90/pve,/obj/item/ammo_magazine/rifle/rmc_f90/pve,/obj/item/ammo_magazine/rifle/rmc_f90/pve,/obj/item/ammo_magazine/rifle/rmc_f90/pve,/obj/item/ammo_magazine/rifle/rmc_f90/pve{pixel_x = -6},/obj/item/ammo_magazine/rifle/rmc_f90/pve{pixel_x = -6},/obj/item/ammo_magazine/rifle/rmc_f90/pve{pixel_x = -6},/obj/item/ammo_magazine/rifle/rmc_f90/pve{pixel_x = -6},/obj/item/ammo_magazine/rifle/rmc_f90/pve{pixel_x = -6},/obj/item/ammo_magazine/rifle/rmc_f90/pve{pixel_x = -6},/obj/item/ammo_magazine/rifle/rmc_f90/pve{pixel_x = 7},/obj/item/ammo_magazine/rifle/rmc_f90/pve{pixel_x = 7},/obj/item/ammo_magazine/rifle/rmc_f90/pve{pixel_x = 7},/obj/item/ammo_magazine/rifle/rmc_f90/pve{pixel_x = 7},/obj/item/storage/belt/marine/rmc/rmc_f90_ammo/pve,/obj/item/storage/belt/marine/rmc/rmc_f90_ammo/pve{pixel_y = -4},/turf/open/shuttle/dropship{icon_state = "rasputin15"},/area/shuttle/tornado)
"cg" = (/obj/structure/shuttle/part/typhoon/transparent{icon_state = "66"},/turf/template_noop,/area/shuttle/tornado)
"cH" = (/turf/open/shuttle/dropship{icon_state = "rasputin15"},/area/shuttle/tornado)
"dV" = (/turf/closed/shuttle/typhoon{icon_state = "75"},/area/shuttle/tornado)
"et" = (/turf/closed/shuttle/typhoon{icon_state = "77"},/area/shuttle/tornado)
"fJ" = (/obj/structure/shuttle/part/typhoon/transparent{icon_state = "99a"; layer = 2.97},/turf/template_noop,/area/shuttle/tornado)
"gw" = (/obj/structure/shuttle/part/tornado/transparent{icon_state = "27"},/turf/template_noop,/area/shuttle/tornado)
"gx" = (/turf/closed/shuttle/typhoon{icon_state = "47"},/area/shuttle/tornado)
"gJ" = (/obj/structure/machinery/camera/autoname/golden_arrow/typhoon{dir = 8; pixel_x = 24},/obj/structure/closet/crate/ammo/alt,/turf/open/shuttle/dropship{icon_state = "rasputin15"},/area/shuttle/tornado)
"gN" = (/turf/closed/shuttle/typhoon{icon_state = "24"},/area/shuttle/tornado)
"gY" = (/turf/closed/shuttle/typhoon{icon_state = "67"},/area/shuttle/tornado)
"hj" = (/obj/item/storage/firstaid/adv{pixel_x = 10; pixel_y = 7},/obj/item/storage/pouch/medical/full{pixel_y = 6},/turf/open/shuttle/dropship{icon_state = "rasputin3"},/area/shuttle/tornado)
"ix" = (/obj/structure/machinery/cm_vending/sorted/medical/wall_med/limited{pixel_y = 25},/obj/structure/bed/chair/dropship/passenger/folded{buckling_y = 3; dir = 4; pixel_y = 3},/turf/open/shuttle/dropship{icon_state = "rasputin7"},/area/shuttle/tornado)
"iz" = (/turf/open/shuttle/dropship{icon_state = "floor8"},/area/shuttle/tornado)
"iH" = (/obj/structure/bed/chair/dropship/passenger/folded{buckling_y = 8; pixel_y = 8},/turf/open/shuttle/dropship{icon_state = "rasputin15"},/area/shuttle/tornado)
"ji" = (/obj/structure/platform_decoration{dir = 8},/obj/structure/platform_decoration{dir = 4},/turf/open/shuttle/dropship{icon_state = "rasputin15"},/area/shuttle/tornado)
"jt" = (/obj/structure/shuttle/part/typhoon/transparent{icon_state = "102"},/turf/template_noop,/area/shuttle/tornado)
"kY" = (/obj/structure/bed/chair/dropship/passenger{dir = 8},/obj/structure/barricade/handrail{dir = 1},/turf/open/shuttle/dropship{icon_state = "rasputin15"},/area/shuttle/tornado)
"lm" = (/obj/structure/machinery/light/double{dir = 4; pixel_y = -5},/turf/open/shuttle/dropship{icon_state = "rasputin15"},/area/shuttle/tornado)
"lA" = (/turf/closed/shuttle/typhoon{icon_state = "73"},/area/shuttle/tornado)
"lM" = (/turf/closed/shuttle/typhoon{icon_state = "48"},/area/shuttle/tornado)
"nM" = (/turf/closed/shuttle/typhoon{icon_state = "64"},/area/shuttle/tornado)
"of" = (/turf/closed/shuttle/typhoon{icon_state = "25"},/area/shuttle/tornado)
"oo" = (/obj/structure/stairs/perspective{can_block_movement = 0; icon_state = "p_stair_full"},/obj/structure/platform{dir = 4},/obj/structure/platform{dir = 8},/turf/open/shuttle/dropship{icon_state = "rasputin15"},/area/shuttle/tornado)
"oH" = (/obj/structure/shuttle/part/typhoon/transparent{icon_state = "95a"},/turf/template_noop,/area/shuttle/tornado)
"qa" = (/obj/structure/shuttle/part/typhoon/transparent{icon_state = "101"},/turf/template_noop,/area/shuttle/tornado)
"ql" = (/obj/structure/surface/table/almayer,/obj/item/weapon/gun/bionational/laser_rifle{pixel_y = 11},/obj/item/weapon/gun/bionational/laser_rifle{pixel_y = -6},/obj/item/ammo_magazine/rifle/bionational{pixel_x = 10},/obj/item/ammo_magazine/rifle/bionational{pixel_x = 17},/obj/item/ammo_magazine/rifle/bionational{pixel_x = -2},/obj/item/ammo_magazine/rifle/bionational{pixel_x = -11},/obj/item/ammo_magazine/rifle/bionational{pixel_x = 10},/obj/item/ammo_magazine/rifle/bionational{pixel_x = -2},/obj/item/ammo_magazine/rifle/bionational{pixel_x = -11},/obj/item/ammo_magazine/rifle/bionational{pixel_x = 17},/turf/open/shuttle/dropship{icon_state = "rasputin15"},/area/shuttle/tornado)
"rb" = (/turf/closed/shuttle/typhoon{icon_state = "104"},/area/shuttle/tornado)
"rN" = (/obj/structure/bed/portable_surgery{pixel_y = 5},/obj/structure/machinery/iv_drip{layer = 2.9; pixel_y = 26},/obj/structure/curtain/medical,/turf/open/shuttle/dropship{icon_state = "rasputin15"},/area/shuttle/tornado)
"rO" = (/turf/closed/shuttle/typhoon{icon_state = "72"},/area/shuttle/tornado)
"sC" = (/obj/effect/attach_point/crew_weapon/typhoon,/turf/open/shuttle/dropship{icon_state = "rasputin3"},/area/shuttle/tornado)
"uS" = (/obj/structure/shuttle/part/typhoon/transparent{icon_state = "3"},/turf/template_noop,/area/shuttle/tornado)
"vO" = (/obj/structure/shuttle/part/typhoon/transparent{density = 0; icon_state = "41"; layer = 4.2},/obj/structure/shuttle/part/typhoon/transparent{icon_state = "61"},/turf/template_noop,/area/shuttle/tornado)
"wd" = (/turf/closed/shuttle/typhoon{icon_state = "36"},/area/shuttle/tornado)
"wI" = (/obj/structure/shuttle/part/typhoon/transparent{icon_state = "16"},/turf/template_noop,/area/shuttle/tornado)
"wN" = (/turf/open/shuttle/dropship{icon_state = "rasputin8"},/area/shuttle/tornado)
"wP" = (/obj/structure/bed/chair/dropship/passenger{dir = 8},/turf/open/shuttle/dropship{icon_state = "rasputin15"},/area/shuttle/tornado)
"xq" = (/turf/closed/shuttle/typhoon{icon_state = "69"},/area/shuttle/tornado)
"yk" = (/turf/closed/shuttle/typhoon/transparent{icon_state = "89a"},/area/shuttle/tornado)
"yE" = (/obj/structure/shuttle/part/typhoon/transparent{density = 0; icon_state = "41"; layer = 4.2},/turf/template_noop,/area/shuttle/tornado)
"zS" = (/turf/closed/shuttle/typhoon/transparent{icon_state = "89b"},/area/shuttle/tornado)
"Au" = (/obj/structure/shuttle/part/typhoon/transparent{icon_state = "5"},/turf/template_noop,/area/shuttle/tornado)
"Bf" = (/obj/structure/platform_decoration{dir = 4},/obj/structure/platform_decoration{dir = 8},/turf/open/shuttle/dropship{icon_state = "rasputin15"},/area/shuttle/tornado)
"Bz" = (/obj/structure/shuttle/part/tornado/transparent{icon_state = "23"},/obj/structure/shuttle/part/typhoon/transparent{icon_state = "23"},/turf/template_noop,/area/shuttle/tornado)
"BO" = (/obj/structure/shuttle/part/tornado/transparent{icon_state = "15"},/turf/template_noop,/area/shuttle/tornado)
"BP" = (/obj/structure/shuttle/part/typhoon/transparent{icon_state = "17"},/turf/template_noop,/area/shuttle/tornado)
"Cl" = (/obj/structure/shuttle/part/typhoon/transparent{icon_state = "6"},/turf/template_noop,/area/shuttle/tornado)
"CE" = (/turf/closed/shuttle/typhoon/transparent{icon_state = "86b"},/area/shuttle/tornado)
"Dl" = (/turf/closed/shuttle/typhoon{icon_state = "83"},/area/shuttle/tornado)
"Dv" = (/obj/structure/shuttle/part/typhoon/transparent{icon_state = "32"},/turf/template_noop,/area/shuttle/tornado)
"Eh" = (/obj/effect/attach_point/crew_weapon/typhoon,/turf/open/shuttle/dropship{icon_state = "rasputin15"},/area/shuttle/tornado)
"Fm" = (/turf/closed/shuttle/typhoon/transparent{icon_state = "86a"},/area/shuttle/tornado)
"FC" = (/obj/structure/machinery/light/double{dir = 4; pixel_y = -5},/obj/structure/bed/chair/dropship/passenger{dir = 8},/turf/open/shuttle/dropship{icon_state = "rasputin15"},/area/shuttle/tornado)
"FO" = (/obj/structure/shuttle/part/typhoon/transparent{icon_state = "100"},/turf/template_noop,/area/shuttle/tornado)
"Gv" = (/obj/structure/shuttle/part/typhoon/transparent{icon_state = "70"},/turf/template_noop,/area/shuttle/tornado)
"Ih" = (/obj/structure/platform{dir = 1},/obj/structure/blocker/forcefield/multitile_vehicles,/obj/structure/ob_ammo/ob_fuel{pixel_y = 6},/obj/structure/ob_ammo/ob_fuel,/turf/open/shuttle/dropship{icon_state = "rasputin3"},/area/shuttle/tornado)
"Iw" = (/obj/structure/machinery/light/double{dir = 8; pixel_y = -5},/obj/structure/bed/chair/dropship/passenger{dir = 4},/turf/open/shuttle/dropship{icon_state = "rasputin15"},/area/shuttle/tornado)
"IT" = (/obj/structure/shuttle/part/typhoon/transparent{density = 0; icon_state = "40"; layer = 4.2},/turf/template_noop,/area/shuttle/tornado)
"IU" = (/obj/structure/bed/chair/dropship/passenger{dir = 4},/turf/open/shuttle/dropship{icon_state = "rasputin15"},/area/shuttle/tornado)
"IX" = (/obj/structure/shuttle/part/typhoon/transparent{icon_state = "26"},/turf/template_noop,/area/shuttle/tornado)
"IZ" = (/turf/open/shuttle/dropship{icon_state = "rasputin4"},/area/shuttle/tornado)
"Jb" = (/obj/structure/shuttle/part/typhoon/transparent{icon_state = "33"},/turf/template_noop,/area/shuttle/tornado)
"JT" = (/obj/structure/shuttle/part/typhoon/transparent{icon_state = "23"},/turf/template_noop,/area/shuttle/tornado)
"Kp" = (/obj/effect/decal/warning_stripes{icon_state = "N"; pixel_y = -1},/obj/effect/decal/warning_stripes{icon_state = "S"; pixel_y = 2},/obj/structure/machinery/door/airlock/multi_tile/almayer/dropshiprear/ds2{id = "aft_door"; name = "\improper Typhoon cargo door"},/turf/open/shuttle/dropship{icon_state = "rasputin14"},/area/shuttle/tornado)
"Kw" = (/obj/structure/shuttle/part/typhoon/transparent{icon_state = "28"},/obj/effect/attach_point/fuel/typhoon{layer = 3.1},/turf/template_noop,/area/shuttle/tornado)
"KX" = (/obj/structure/shuttle/part/typhoon/transparent{icon_state = "22"},/turf/template_noop,/area/shuttle/tornado)
"KY" = (/obj/structure/machinery/light/double{dir = 8; pixel_y = -5},/obj/structure/bed/chair/vehicle/toc{dir = 1; pixel_x = 16; pixel_y = 19},/turf/open/shuttle/dropship{icon_state = "rasputin15"},/area/shuttle/tornado)
"Lj" = (/obj/structure/shuttle/part/typhoon/transparent{icon_state = "4"},/turf/template_noop,/area/shuttle/tornado)
"LV" = (/obj/structure/reagent_dispensers/fueltank{desc = "A fuel tank mix with fuel designed for various spacecraft, very combustible."; icon = 'icons/obj/structures/props/hybrisarandomprops.dmi'; name = "spacecraft fuel-mix tank"},/turf/open/shuttle/dropship{icon_state = "rasputin3"},/area/shuttle/tornado)
"MB" = (/turf/closed/shuttle/typhoon/transparent{icon_state = "97a"},/area/shuttle/tornado)
"NB" = (/obj/structure/machinery/light/double{dir = 8; pixel_y = -5},/turf/open/shuttle/dropship{icon_state = "rasputin15"},/area/shuttle/tornado)
"Oh" = (/turf/closed/shuttle/typhoon{icon_state = "103"},/area/shuttle/tornado)
"Oq" = (/obj/structure/machinery/camera/autoname/golden_arrow/typhoon{dir = 4; pixel_x = -24},/obj/structure/bed/chair/dropship/passenger{dir = 4},/obj/structure/barricade/handrail{dir = 1},/turf/open/shuttle/dropship{icon_state = "rasputin15"},/area/shuttle/tornado)
"Or" = (/turf/closed/shuttle/typhoon{icon_state = "82"},/area/shuttle/tornado)
"Ou" = (/obj/structure/stairs/perspective{dir = 1; icon_state = "p_stair_full"; pixel_y = 22},/obj/structure/bed/chair/vehicle/dropship_cockpit/copilot{dir = 1; layer = 5; pixel_x = 8},/obj/structure/machinery/computer/dropship_weapons/typhoon/small{pixel_x = 8; pixel_y = 8},/turf/open/shuttle/dropship{icon_state = "rasputin15"},/area/shuttle/tornado)
"OQ" = (/obj/structure/stairs/perspective{can_block_movement = 0; icon_state = "p_stair_full"},/obj/structure/platform{dir = 8},/obj/structure/platform{dir = 4},/turf/open/shuttle/dropship{icon_state = "rasputin15"},/area/shuttle/tornado)
"OV" = (/obj/structure/shuttle/part/tornado/transparent{icon_state = "28"},/turf/template_noop,/area/shuttle/tornado)
"Pq" = (/obj/effect/decal/warning_stripes{icon_state = "S"; pixel_y = 2},/obj/effect/decal/warning_stripes{icon_state = "N"; pixel_y = -1},/turf/open/shuttle/dropship{icon_state = "rasputin14"},/area/shuttle/tornado)
"Qi" = (/obj/structure/shuttle/part/typhoon/transparent{icon_state = "38"},/turf/template_noop,/area/shuttle/tornado)
"Qs" = (/obj/structure/machinery/door/airlock/hatch/cockpit/two,/obj/structure/blocker/forcefield/multitile_vehicles,/turf/open/shuttle/dropship{icon_state = "rasputin15"},/area/shuttle/tornado)
"QF" = (/turf/closed/shuttle/typhoon{icon_state = "62"},/area/shuttle/tornado)
"Rb" = (/obj/structure/shuttle/part/typhoon/transparent{icon_state = "29"},/turf/template_noop,/area/shuttle/tornado)
"Rw" = (/turf/closed/shuttle/typhoon{icon_state = "31"},/area/shuttle/tornado)
"RB" = (/obj/structure/shuttle/part/typhoon/transparent{icon_state = "39"},/turf/template_noop,/area/shuttle/tornado)
"RH" = (/obj/structure/shuttle/part/typhoon/transparent{icon_state = "27"},/turf/template_noop,/area/shuttle/tornado)
"Sc" = (/obj/structure/shuttle/part/typhoon/transparent{icon_state = "74"},/turf/template_noop,/area/shuttle/tornado)
"Tc" = (/obj/structure/shuttle/part/tornado/transparent{icon_state = "29"},/obj/structure/shuttle/part/typhoon/transparent{icon_state = "29"},/turf/template_noop,/area/shuttle/tornado)
"Ts" = (/obj/structure/shuttle/part/typhoon/transparent{icon_state = "2"},/turf/template_noop,/area/shuttle/tornado)
"TF" = (/obj/structure/shuttle/part/typhoon/transparent{density = 0; icon_state = "40"; layer = 4.2},/obj/structure/shuttle/part/typhoon/transparent{icon_state = "65"},/turf/template_noop,/area/shuttle/tornado)
"Uk" = (/obj/structure/shuttle/part/typhoon/transparent,/turf/template_noop,/area/shuttle/tornado)
"Ut" = (/obj/structure/machinery/camera/autoname/golden_arrow/typhoon{pixel_y = 32},/obj/structure/surface/table/reinforced/toc/east{pixel_y = -7},/obj/structure/machinery/computer/railgun/gatling/toc{pixel_x = -7; pixel_y = 13},/obj/structure/phone_base/toc{name = "Typhoon overwatch telephone receiver"; phone_category = "Overwatch"; phone_id = "Typhoon Overwatch"; pixel_x = 11; pixel_y = 13},/obj/item/device/motiondetector{pixel_x = 3},/turf/open/shuttle/dropship{icon_state = "rasputin6"},/area/shuttle/tornado)
"VM" = (/obj/structure/shuttle/part/typhoon/transparent{icon_state = "9"},/turf/template_noop,/area/shuttle/tornado)
"VV" = (/obj/structure/shuttle/part/tornado/transparent{icon_state = "22"},/turf/template_noop,/area/shuttle/tornado)
"Wk" = (/obj/docking_port/mobile/marine_dropship/typhoon,/obj/structure/bed/chair/dropship/passenger/folded{buckling_y = 8; pixel_y = 8},/turf/open/shuttle/dropship{icon_state = "rasputin15"},/area/shuttle/tornado)
"Wq" = (/obj/structure/closet/crate/construction,/obj/item/stack/sheet/metal/large_stack,/obj/item/stack/sheet/plasteel/large_stack,/obj/item/storage/belt/gun/utility/full,/turf/open/shuttle/dropship{icon_state = "rasputin15"},/area/shuttle/tornado)
"Xv" = (/obj/structure/phone_base{dir = 4; layer = 3.1; name = "Typhoon telephone receiver"; phone_category = "Dropship"; phone_id = "Typhoon"; pixel_x = -19; pixel_y = 12},/obj/structure/bed/chair/vehicle/dropship_cockpit/pilot{dir = 1; pixel_x = 6; pixel_y = 8},/obj/structure/machinery/computer/shuttle/dropship/flight/small{pixel_x = 6; pixel_y = 16},/turf/open/shuttle/dropship{icon_state = "rasputin15"},/area/shuttle/tornado)
"Xw" = (/obj/structure/shuttle/part/typhoon/transparent{icon_state = "32"},/obj/effect/attach_point/fuel/typhoon{layer = 3.1},/turf/template_noop,/area/shuttle/tornado)
"XO" = (/obj/structure/machinery/light/double{dir = 4; pixel_y = -5},/obj/structure/surface/table/almayer,/obj/item/storage/surgical_tray/empty,/obj/item/reagent_container/hypospray/autoinjector/oxycodone{pixel_x = -3; pixel_y = 9},/obj/item/storage/pouch/autoinjector/full{pixel_y = 7},/obj/item/storage/pouch/autoinjector/full,/obj/item/storage/pouch/medical/full{pixel_x = -6},/turf/open/shuttle/dropship{icon_state = "rasputin15"},/area/shuttle/tornado)
"Ym" = (/obj/structure/machinery/computer/overwatch/toc{pixel_y = 14},/obj/structure/surface/table/reinforced/toc/west{pixel_y = -7},/obj/structure/machinery/prop/almayer/CICmap/arc{pixel_x = -9; pixel_y = 9},/obj/structure/machinery/computer/railgun/toc{pixel_x = 7; pixel_y = 14},/turf/open/shuttle/dropship{icon_state = "rasputin15"},/area/shuttle/tornado)
"YW" = (/obj/structure/shuttle/part/typhoon/transparent{icon_state = "71"},/turf/template_noop,/area/shuttle/tornado)
"Zk" = (/turf/closed/shuttle/typhoon{icon_state = "30"},/area/shuttle/tornado)
"ZD" = (/turf/open/shuttle/dropship{icon_state = "rasputin3"},/area/shuttle/tornado)
"ZR" = (/turf/closed/shuttle/typhoon{icon_state = "37"},/area/shuttle/tornado)

(1,1,1) = {"
aXaXaXaXFOqajtaXaXaXaX
aXaXaXaXoHMBfJaXaXaXaX
aXaXaXaXCEXvzSaXaXaXaX
aXaXITyEFmOuykITyEaXaX
aXaXdVetOrQsetetDlaXaX
aXYWrOYmUtizixrNlAScaX
aXcggYKYZDcHhjXOxqGvaX
aXcggYOqZDbyZDkYxqGvaX
ITvOQFIUZDWkZDwPnMTFyE
QiRBwdIwZDiHZDFCZRQiRB
KwRbZkIUIZizwNwPRwXwJb
KXJTgNEhOQqlooEhofIXRH
wIBPVMgxBfIhjilMBOwIBP
aXITyEwdcHZDgJZRITyEaX
aXOVTcZkNBsClmRwDvJbaX
aXVVBzgNWqLVcHofbsgwaX
aXwIBPOhKpPqPqrbwIBPaX
aXUkTsuSaXaXaXLjAuClaX
"}
